000000000000000000000000000000000
0...............................0
0...............................0
0...............................0
0...............................0
dp..............................0
11...2..1.......................0
000000000000000000000000000000000
