00000000000000000000000000000000
00000000000..........111111....0
00000000000..........111111....0
00000000000..........111111....0
00000000000..........111111....0
0.........2..........111111...pd
0.........2..........111111...22
0.........2......000011111100000
0.........2......000011111100000
0.p.......2......000011111100000
0.s.......2......000001111100000
00000000000000000000000000000000
