0000000000000000
0..............0
0..............0
0.............pd
0.............33
0222222222222220
0..............0
0..............0
0111111111111110
0..............0
0..............0
0222222222222220
0..............0
0..............0
0111111111111110
0..............0
dp.............0
11.............0
0000000000000000
