000000000000000000000000000000000
0...............................0
0...............................0
0...............................0
0...............................0
d...............................0
1....2..1.......................0
000000000000000000000000000000000
