0000000000000000000000000000000000
0111111111111111111111111111111110
0111111111111111111111111111111110
0111111111111111111111111111111110
0111111111111111111111111111111110
0111111111111111111111111111111110
0111111111111111111111111111111110
0111111111111111111111111111111110
0111111111111111111111111111111110
0111111111111111111111111111111110
0111111111111111111111111111111110
0111111111111111111111111111111110
0111111111111111111111111111111110
0111111111111111111111111111111110
0111111111111111111111111111111110
0..........11111111111111111111110
0..........11111111111111111111110
dp.........11111111111111111111110
22.........11111111111111111111110
0000000000000000000000000000000000
